//MAP CONVERTED BY dmm2tgm.py THIS HEADER COMMENT PREVENTS RECONVERSION, DO NOT REMOVE
"aa" = (
/obj/effect/decal/warning_stripes{
	icon_state = "W"
	},
/obj/effect/decal/warning_stripes{
	icon_state = "S"
	},
/turf/open/floor/wood,
/area/template_noop)
"ab" = (
/obj/effect/decal/warning_stripes{
	icon_state = "N"
	},
/obj/effect/decal/warning_stripes{
	icon_state = "W"
	},
/turf/open/floor/wood,
/area/template_noop)
"ac" = (
/obj/structure/desertdam/decals/road_edge{
	icon_state = "road_edge_decal3";
	pixel_y = -12
	},
/obj/structure/desertdam/decals/road_edge{
	pixel_x = -12
	},
/turf/open/floor/wood,
/area/template_noop)
"ad" = (
/obj/effect/decal/warning_stripes{
	icon_state = "E-corner"
	},
/obj/effect/decal/warning_stripes{
	icon_state = "N"
	},
/turf/open/floor/wood,
/area/template_noop)
"ae" = (
/obj/item/trash/cigbutt{
	pixel_x = 5;
	pixel_y = -6
	},
/turf/open/floor/wood,
/area/template_noop)
"af" = (
/obj/effect/landmark/corpsespawner/ua_riot,
/obj/effect/decal/cleanable/blood,
/obj/item/restraint/handcuffs/zip{
	pixel_y = -12
	},
/turf/open/floor/wood,
/area/template_noop)
"ag" = (
/obj/effect/decal/warning_stripes{
	icon_state = "NS-center"
	},
/obj/effect/decal/warning_stripes{
	icon_state = "S"
	},
/turf/open/floor/wood,
/area/template_noop)
"ah" = (
/obj/structure/desertdam/decals/road_edge{
	pixel_x = 2
	},
/obj/structure/desertdam/decals/road_edge{
	icon_state = "road_edge_decal3";
	pixel_y = -12
	},
/turf/open/floor/wood,
/area/template_noop)
"ai" = (
/obj/effect/decal/warning_stripes{
	icon_state = "S"
	},
/obj/effect/decal/warning_stripes{
	icon_state = "N"
	},
/obj/effect/decal/warning_stripes{
	icon_state = "E-corner"
	},
/turf/open/floor/wood,
/area/template_noop)
"aj" = (
/obj/effect/decal/warning_stripes{
	icon_state = "E-corner"
	},
/turf/open/floor/wood,
/area/template_noop)
"ak" = (
/obj/item/ammo_casing{
	dir = 6;
	icon_state = "casing_10_1"
	},
/turf/open/floor/wood,
/area/template_noop)
"al" = (
/obj/effect/decal/warning_stripes{
	icon_state = "S"
	},
/obj/effect/decal/warning_stripes{
	icon_state = "W"
	},
/obj/effect/decal/warning_stripes{
	icon_state = "N"
	},
/turf/open/floor/wood,
/area/template_noop)
"am" = (
/obj/structure/desertdam/decals/road_edge{
	icon_state = "road_edge_decal3";
	pixel_y = -12
	},
/turf/open/floor/wood,
/area/template_noop)
"an" = (
/obj/effect/decal/warning_stripes{
	icon_state = "NS-center"
	},
/turf/open/floor/wood,
/area/template_noop)
"ao" = (
/obj/structure/desertdam/decals/road_edge{
	icon_state = "road_edge_decal3";
	pixel_y = -12
	},
/obj/structure/desertdam/decals/road_edge{
	pixel_x = 16
	},
/turf/open/floor/wood,
/area/template_noop)
"ap" = (
/obj/effect/decal/warning_stripes{
	icon_state = "N"
	},
/obj/effect/decal/warning_stripes{
	icon_state = "E-corner"
	},
/turf/open/floor/wood,
/area/template_noop)
"aq" = (
/obj/structure/desertdam/decals/road_edge{
	pixel_x = -12
	},
/obj/structure/desertdam/decals/road_edge{
	icon_state = "road_edge_decal3"
	},
/turf/open/floor/wood,
/area/template_noop)
"ar" = (
/obj/effect/decal/warning_stripes{
	icon_state = "NS-center"
	},
/obj/effect/decal/warning_stripes{
	icon_state = "N"
	},
/turf/open/floor/wood,
/area/template_noop)
"as" = (
/obj/effect/decal/warning_stripes{
	icon_state = "N"
	},
/turf/open/floor/wood,
/area/template_noop)
"at" = (
/obj/structure/desertdam/decals/road_edge{
	icon_state = "road_edge_decal5";
	pixel_x = -2
	},
/obj/structure/desertdam/decals/road_edge{
	icon_state = "road_edge_decal3"
	},
/turf/open/floor/wood,
/area/template_noop)
"au" = (
/obj/effect/decal/warning_stripes{
	icon_state = "N"
	},
/obj/item/spacecash/c100{
	pixel_x = -11;
	pixel_y = -6
	},
/turf/open/floor/wood,
/area/template_noop)
"av" = (
/obj/structure/desertdam/decals/road_edge{
	icon_state = "road_edge_decal3";
	pixel_x = -6
	},
/obj/structure/desertdam/decals/road_edge{
	icon_state = "road_edge_decal3";
	pixel_x = 9
	},
/obj/item/weapon/gun/shotgun/pump/dual_tube/cmb,
/turf/open/floor/wood,
/area/template_noop)
"aw" = (
/obj/effect/decal/warning_stripes{
	icon_state = "N"
	},
/obj/effect/decal/warning_stripes{
	icon_state = "W"
	},
/obj/item/trash/barcardine,
/turf/open/floor/wood,
/area/template_noop)
"ax" = (
/obj/effect/decal/warning_stripes{
	icon_state = "E-corner"
	},
/obj/effect/decal/warning_stripes{
	icon_state = "S"
	},
/turf/open/floor/wood,
/area/template_noop)
"ay" = (
/obj/structure/desertdam/decals/road_edge{
	icon_state = "road_edge_decal7";
	pixel_x = 2;
	pixel_y = -4
	},
/obj/structure/desertdam/decals/road_edge{
	pixel_x = 2;
	pixel_y = 23
	},
/turf/open/floor/wood,
/area/template_noop)
"az" = (
/obj/structure/desertdam/decals/road_edge{
	pixel_x = 2
	},
/turf/open/floor/wood,
/area/template_noop)
"aA" = (
/obj/structure/desertdam/decals/road_edge{
	icon_state = "road_edge_decal8";
	pixel_x = -2;
	pixel_y = -4
	},
/obj/structure/desertdam/decals/road_edge{
	pixel_x = 2;
	pixel_y = 23
	},
/turf/open/floor/wood,
/area/template_noop)
"aB" = (
/obj/structure/desertdam/decals/road_edge{
	icon_state = "road_edge_decal3";
	pixel_x = -6
	},
/obj/structure/desertdam/decals/road_edge{
	icon_state = "road_edge_decal3";
	pixel_x = 9
	},
/turf/open/floor/wood,
/area/template_noop)
"aC" = (
/obj/effect/decal/warning_stripes{
	icon_state = "NS-center"
	},
/obj/effect/decal/warning_stripes,
/turf/open/floor/wood,
/area/template_noop)
"aD" = (
/obj/structure/desertdam/decals/road_edge{
	icon_state = "road_edge_decal6";
	pixel_x = 2
	},
/obj/structure/desertdam/decals/road_edge{
	icon_state = "road_edge_decal3"
	},
/turf/open/floor/wood,
/area/template_noop)
"aE" = (
/obj/structure/desertdam/decals/road_edge{
	pixel_x = 16
	},
/obj/structure/desertdam/decals/road_edge{
	icon_state = "road_edge_decal3"
	},
/turf/open/floor/wood,
/area/template_noop)
"aF" = (
/obj/structure/holohoop{
	dir = 4
	},
/obj/structure/desertdam/decals/road_edge{
	pixel_x = -12
	},
/obj/structure/desertdam/decals/road_edge{
	icon_state = "road_edge_decal5";
	pixel_x = -16;
	pixel_y = 16
	},
/obj/structure/desertdam/decals/road_edge{
	icon_state = "road_edge_decal8";
	pixel_x = -16;
	pixel_y = -16
	},
/obj/structure/desertdam/decals/road_edge{
	icon_state = "road_edge_decal6";
	pixel_x = 16;
	pixel_y = 16
	},
/obj/structure/desertdam/decals/road_edge{
	icon_state = "road_edge_decal7";
	pixel_x = 16;
	pixel_y = -16
	},
/turf/open/floor/wood,
/area/template_noop)
"aG" = (
/obj/effect/decal/warning_stripes{
	icon_state = "W"
	},
/turf/open/floor/wood,
/area/template_noop)
"aH" = (
/obj/item/trash/chunk,
/turf/open/floor/wood,
/area/template_noop)
"aI" = (
/obj/structure/desertdam/decals/road_edge{
	icon_state = "road_edge_decal7";
	pixel_x = 16;
	pixel_y = -16
	},
/obj/structure/desertdam/decals/road_edge{
	icon_state = "road_edge_decal6";
	pixel_x = 16;
	pixel_y = 16
	},
/obj/structure/desertdam/decals/road_edge{
	icon_state = "road_edge_decal5";
	pixel_x = -16;
	pixel_y = 16
	},
/obj/structure/desertdam/decals/road_edge{
	icon_state = "road_edge_decal8";
	pixel_x = -16;
	pixel_y = -16
	},
/turf/open/floor/wood,
/area/template_noop)
"aJ" = (
/obj/item/weapon/gun/smg/mac15{
	pixel_x = 12
	},
/turf/open/floor/wood,
/area/template_noop)
"aK" = (
/obj/item/toy/beach_ball/holoball,
/obj/structure/desertdam/decals/road_edge{
	icon_state = "road_edge_decal6";
	pixel_x = 16;
	pixel_y = 16
	},
/obj/structure/desertdam/decals/road_edge{
	icon_state = "road_edge_decal5";
	pixel_x = -16;
	pixel_y = 16
	},
/obj/structure/desertdam/decals/road_edge{
	icon_state = "road_edge_decal8";
	pixel_x = -16;
	pixel_y = -16
	},
/obj/structure/desertdam/decals/road_edge{
	icon_state = "road_edge_decal7";
	pixel_x = 16;
	pixel_y = -16
	},
/turf/open/floor/wood,
/area/template_noop)
"aL" = (
/obj/effect/decal/warning_stripes{
	icon_state = "S"
	},
/turf/open/floor/wood,
/area/template_noop)
"aM" = (
/obj/effect/decal/warning_stripes{
	icon_state = "E-corner"
	},
/obj/effect/decal/warning_stripes,
/obj/structure/holohoop{
	dir = 8
	},
/turf/open/floor/wood,
/area/template_noop)
"aN" = (
/obj/structure/desertdam/decals/road_edge{
	icon_state = "road_edge_decal5";
	pixel_x = -16;
	pixel_y = 16
	},
/obj/structure/desertdam/decals/road_edge{
	icon_state = "road_edge_decal8";
	pixel_x = -16;
	pixel_y = -16
	},
/obj/structure/desertdam/decals/road_edge{
	icon_state = "road_edge_decal6";
	pixel_x = 16;
	pixel_y = 16
	},
/obj/structure/desertdam/decals/road_edge{
	icon_state = "road_edge_decal7";
	pixel_x = 16;
	pixel_y = -16
	},
/turf/open/floor/wood,
/area/template_noop)
"aO" = (
/obj/structure/holohoop{
	dir = 8
	},
/obj/structure/desertdam/decals/road_edge{
	pixel_x = 16
	},
/obj/structure/desertdam/decals/road_edge{
	icon_state = "road_edge_decal5";
	pixel_x = -16;
	pixel_y = 16
	},
/obj/structure/desertdam/decals/road_edge{
	icon_state = "road_edge_decal8";
	pixel_x = -16;
	pixel_y = -16
	},
/obj/structure/desertdam/decals/road_edge{
	icon_state = "road_edge_decal6";
	pixel_x = 16;
	pixel_y = 16
	},
/obj/structure/desertdam/decals/road_edge{
	icon_state = "road_edge_decal7";
	pixel_x = 16;
	pixel_y = -16
	},
/turf/open/floor/wood,
/area/template_noop)
"aP" = (
/obj/structure/desertdam/decals/road_edge{
	pixel_x = -12
	},
/obj/structure/desertdam/decals/road_edge{
	icon_state = "road_edge_decal3";
	pixel_y = 4
	},
/turf/open/floor/wood,
/area/template_noop)
"aQ" = (
/obj/effect/decal/warning_stripes{
	icon_state = "W"
	},
/obj/effect/decal/warning_stripes{
	icon_state = "N"
	},
/turf/open/floor/wood,
/area/template_noop)
"aR" = (
/obj/effect/decal/warning_stripes{
	icon_state = "W"
	},
/obj/effect/decal/warning_stripes,
/obj/structure/holohoop{
	dir = 4
	},
/turf/open/floor/wood,
/area/template_noop)
"aS" = (
/obj/effect/decal/warning_stripes{
	icon_state = "S"
	},
/obj/effect/decal/warning_stripes{
	icon_state = "N"
	},
/turf/open/floor/wood,
/area/template_noop)
"aT" = (
/obj/effect/decal/warning_stripes{
	icon_state = "E-corner"
	},
/obj/item/weapon/gun/shotgun/pump/dual_tube/cmb,
/turf/open/floor/wood,
/area/template_noop)
"aU" = (
/obj/item/ammo_magazine/smg/uzi{
	current_rounds = 0;
	pixel_x = 5;
	pixel_y = 12
	},
/turf/open/floor/wood,
/area/template_noop)
"aV" = (
/obj/structure/desertdam/decals/road_edge{
	icon_state = "road_edge_decal8";
	pixel_x = -2
	},
/obj/structure/desertdam/decals/road_edge{
	icon_state = "road_edge_decal3";
	pixel_y = 4
	},
/turf/open/floor/wood,
/area/template_noop)
"aW" = (
/obj/effect/decal/cleanable/blood,
/turf/open/floor/wood,
/area/template_noop)
"aX" = (
/obj/structure/desertdam/decals/road_edge{
	icon_state = "road_edge_decal3";
	pixel_x = -9;
	pixel_y = 4
	},
/obj/structure/desertdam/decals/road_edge{
	icon_state = "road_edge_decal3";
	pixel_x = 6;
	pixel_y = 4
	},
/turf/open/floor/wood,
/area/template_noop)
"aY" = (
/turf/open/floor/wood,
/area/template_noop)
"aZ" = (
/obj/effect/decal/warning_stripes{
	icon_state = "NS-center"
	},
/obj/effect/decal/warning_stripes,
/obj/item/toy/beach_ball/holoball,
/turf/open/floor/wood,
/area/template_noop)
"ba" = (
/obj/structure/desertdam/decals/road_edge{
	icon_state = "road_edge_decal6";
	pixel_x = 2;
	pixel_y = 4
	},
/obj/structure/desertdam/decals/road_edge{
	pixel_x = 2;
	pixel_y = -22
	},
/turf/open/floor/wood,
/area/template_noop)
"bb" = (
/obj/effect/decal/ammo_casing{
	dir = 6;
	icon_state = "casing_10_1"
	},
/turf/open/floor/wood,
/area/template_noop)
"bc" = (
/obj/structure/desertdam/decals/road_edge{
	icon_state = "road_edge_decal5";
	pixel_x = -2;
	pixel_y = 4
	},
/obj/structure/desertdam/decals/road_edge{
	pixel_x = 2;
	pixel_y = -22
	},
/obj/effect/decal/cleanable/blood,
/obj/effect/landmark/corpsespawner/ua_riot,
/obj/item/restraint/handcuffs/zip{
	pixel_y = -12
	},
/turf/open/floor/wood,
/area/template_noop)
"bd" = (
/obj/structure/desertdam/decals/road_edge{
	icon_state = "road_edge_decal7";
	pixel_x = 2
	},
/obj/structure/desertdam/decals/road_edge{
	icon_state = "road_edge_decal3";
	pixel_y = 4
	},
/turf/open/floor/wood,
/area/template_noop)
"be" = (
/obj/structure/desertdam/decals/road_edge{
	pixel_x = 16
	},
/obj/structure/desertdam/decals/road_edge{
	icon_state = "road_edge_decal3";
	pixel_y = 4
	},
/turf/open/floor/wood,
/area/template_noop)
"bf" = (
/obj/structure/desertdam/decals/road_edge{
	icon_state = "road_edge_decal3";
	pixel_y = 16
	},
/obj/structure/desertdam/decals/road_edge{
	pixel_x = -12
	},
/turf/open/floor/wood,
/area/template_noop)
"bg" = (
/obj/structure/desertdam/decals/road_edge{
	pixel_x = 2
	},
/obj/structure/desertdam/decals/road_edge{
	icon_state = "road_edge_decal3";
	pixel_y = 16
	},
/obj/item/trash/barcardine,
/turf/open/floor/wood,
/area/template_noop)
"bh" = (
/obj/structure/desertdam/decals/road_edge{
	icon_state = "road_edge_decal3";
	pixel_y = 16
	},
/turf/open/floor/wood,
/area/template_noop)
"bi" = (
/obj/structure/desertdam/decals/road_edge{
	pixel_x = 2
	},
/obj/structure/desertdam/decals/road_edge{
	icon_state = "road_edge_decal3";
	pixel_y = 16
	},
/turf/open/floor/wood,
/area/template_noop)
"bj" = (
/obj/structure/desertdam/decals/road_edge{
	icon_state = "road_edge_decal3";
	pixel_y = 16
	},
/obj/item/spacecash/c100{
	pixel_x = -11;
	pixel_y = -6
	},
/turf/open/floor/wood,
/area/template_noop)
"bk" = (
/obj/structure/desertdam/decals/road_edge{
	icon_state = "road_edge_decal3";
	pixel_y = 16
	},
/obj/structure/desertdam/decals/road_edge{
	pixel_x = 16
	},
/turf/open/floor/wood,
/area/template_noop)

(1,1,1) = {"
bf
aP
aF
aq
ac
"}
(2,1,1) = {"
bg
aV
aY
at
ah
"}
(3,1,1) = {"
bh
aX
aY
av
am
"}
(4,1,1) = {"
bh
ba
aI
ay
am
"}
(5,1,1) = {"
bh
aY
aY
aH
am
"}
(6,1,1) = {"
bh
aY
ae
aY
am
"}
(7,1,1) = {"
bi
az
aK
az
ah
"}
(8,1,1) = {"
bh
aJ
aU
aY
am
"}
(9,1,1) = {"
bh
bb
aW
aY
am
"}
(10,1,1) = {"
bj
bc
aN
aA
am
"}
(11,1,1) = {"
bh
aX
aY
aB
am
"}
(12,1,1) = {"
bi
bd
aY
aD
ah
"}
(13,1,1) = {"
bk
be
aO
aE
ao
"}
